#...#...
........
..#.#...
...S..#.
.#..T...
...#....
........
#.#.#...
1,3,5